{
    "tiles" : [
               [1, 1, 1, 1, 1, 1, 1, 1 ],
               [1, 1, 1, 1, 1, 1, 1, 1 ],
               [1, 0, 1, 0, 1, 0, 1, 1 ],
               [1, 1, 1, 0, 1, 1, 0, 1 ],
               [1, 1, 1, 0, 1, 1, 1, 1 ],
               [1, 0, 1, 0, 1, 1, 1, 1 ],
               [1, 1, 1, 0, 1, 1, 1, 1 ],
               [1, 1, 1, 1, 1, 1, 1, 1 ]],
    
    "obstacles" : [
                [1, 1, 1, 1, 1, 1, 1, 1],
                [1, 0, 0, 0, 0, 0, 0, 1],
                [1, 0, 0, 0, 0, 0, 0, 1],
                [1, 0, 0, 0, 0, 0, 0, 1],
                [1, 0, 0, 0, 0, 0, 0, 1],
                [1, 0, 0, 0, 0, 0, 0, 1],
                [1, 0, 0, 0, 0, 0, 0, 1],
                [1, 1, 1, 1, 1, 1, 1, 1],
    ],
    
    "starting" : [1, 1],
    "targetScore" : 1000,
    "moves" : 15,
}
